OOOOOOOOOOOOOOOOOOOOOOOO
OBBBBBBBBBBBBBBBBBBBBBBO
OBBBBBMBBOOOBBBBBBBPBBBO
OBBBBBBBBBBBBBBBBBBBBBBO
OBBBOOOOBBMBBBBOOBBBBBBO
OBBBBBBBBBBBBBBBBBBBBBBO
OBBOOOOBBBBBBBBBBBOOOBBO
OBBBBBMBBBBBBBBBBBMBBBBO
OBBBBBBBBOOOOOOBBBBBBBBO
OBBBBBBBBBBBBBBBBBBBBBBO
OBBBBOOBBBBBBBBBBBBBBBBO
OBBBBOBBBBBBBBBBBBBBBBBO
OBBBBBBBBBBOOOOOOOBBBBBO
OBBBOOBBBBBBBBBBBBBBBBBO
OBBBBMBBBBMBBBBBBBBMBBBO
OOOOOOOOOOOOOOOOOOOOOOOO