OOOOOOOOOOOOOOOOOOOOOOOO
OBBBBBBBBBBBBBBBBBBBBBBO
OBBBBBMBBBBBBBBBBBBPBBBO
OBBBBBBBBBBBBBBBBBBBBBBO
OBBBOOOOBBMBBBBOOOOBBBBO
OBBBBBBBBBBBBBBBBBBBBBBO
OBBBBBBBBBBBBBBBBBBBBBBO
OBBBBBMBBBBBBBBBBBMBBBBO
OBBBBBBBBOOOOOOBBBBBBBBO
OBBBBBBBBBBBBBBBBBBBBBBO
OBBBBOOBBBBBBBBBBBBBBBBO
OBBBBBBBBBBBBBBBBBBBBBBO
OBBBBBBBBBBOOOOOOOBBBBBO
OBBBOOBBBBBBBBBBBBBBBBBO
OBBBBBBBBBBBBBBBBBBBBBBO
OOOOOOOOOOOOOOOOOOOOOOOO